-1 -1 -1 -1 -1 -1 -1 -1 -1 -1 -1 -1 -1 -1 -1 -1 -1 -1 -1 -1 -1 
-1 -1 -1 -1 22 22 22 22 22 22 22 22 22 22 22 1 1 30 -1 -1 -1 
-1 -1 -1 -1 -1 -1 -1 -1 -1 -1 -1 -1 -1 -1 -1 7 8 31 30 -1 -1 
1 1 30 -1 -1 -1 -1 -1 29 1 1 1 30 -1 -1 7 8 8 31 1 1 
8 8 31 22 22 22 22 22 28 8 8 8 31 22 -1 7 8 8 8 8 8 
15 15 16 -1 -1 -1 -1 -1 14 15 15 15 16 -1 -1 7 8 8 8 8 8 
-1 -1 -1 -1 -1 -1 -1 -1 -1 -1 -1 -1 -1 -1 -1 7 8 8 8 8 8 
-1 -1 -1 -1 22 22 22 -1 -1 -1 -1 -1 -1 -1 -1 7 8 8 8 8 8 
-1 -1 -1 -1 -1 -1 -1 -1 -1 -1 -1 -1 -1 -1 -1 7 8 8 8 8 8 
-1 -1 -1 -1 -1 -1 -1 0 1 2 -1 -1 -1 -1 -1 7 8 8 8 8 8 
1 1 1 1 30 -1 -1 7 8 9 -1 -1 -1 -1 -1 7 8 8 8 8 8 
8 8 8 8 31 1 1 8 8 8 1 1 1 1 1 8 8 8 8 8 8 
