-1 -1 -1 -1 -1 -1 -1 -1 -1 -1 -1 -1 -1 -1 -1 -1 -1 -1 -1 -1 -1 
-1 -1 -1 -1 -1 -1 -1 -1 -1 -1 -1 -1 -1 -1 -1 -1 -1 -1 -1 -1 -1 
-1 -1 -1 -1 -1 -1 -1 -1 -1 -1 -1 -1 -1 -1 -1 -1 -1 -1 -1 -1 -1 
-1 -1 -1 -1 -1 -1 -1 -1 -1 -1 -1 -1 -1 -1 -1 -1 -1 -1 -1 -1 -1 
-1 -1 -1 -1 -1 -1 -1 -1 -1 -1 -1 -1 -1 -1 -1 -1 -1 -1 -1 -1 -1 
-1 -1 -1 -1 -1 -1 29 30 -1 -1 -1 -1 -1 -1 -1 -1 -1 -1 29 1 1 
-1 -1 -1 -1 -1 29 28 31 30 -1 -1 -1 -1 -1 -1 -1 29 1 28 8 8 
-1 -1 -1 -1 -1 27 8 8 31 30 -1 -1 -1 -1 -1 29 28 8 8 8 8 
-1 -1 -1 -1 -1 -1 27 8 8 31 30 -1 -1 -1 29 28 8 8 8 8 8 
-1 -1 -1 -1 -1 -1 -1 27 8 8 31 30 -1 29 28 8 8 8 8 8 8 
1 1 1 1 1 1 1 1 8 8 8 31 1 28 8 8 8 8 8 8 8 
14 15 15 15 15 15 15 15 15 15 15 15 15 15 15 15 15 15 15 15 15 
